Your mission, should you choose to accept it, is to get all of the members of Eboard to agree to vote you in as a CSH member. They've all seen you around these last couple of weeks, but they're all still on the fence about the matter. Perhaps you could try to pry out of them exactly what they'd like to see you do before becoming a member?

Computer Science House: Race To Grace
A Text-Based Adventure Game by Chris Lockfort
Release 1 / Serial number 120122 / Inform 7 build 6G60 (I6/v6.32 lib 6/12N) SD

Lounge
A large common room with lots of windows. To the east lies the main hallway.

Beekman is spread out on one of the couches, watching Sherlock on his laptop. He's wearing a plate carrier with a "Christian Beekman: Tactical Operator" tag on it.

You can also see six couches, a projector, and a media kiosk here.

>take couch
A little Imps-director angel appears on your right shoulder, and gently reminds you that other people need to use the couches too. A little social-director devil appears on your left shoulder, and tells you (in no uncertain terms) that the Imps-director can suck it. Realizing that you couldn't lift the couch by yourself anyway, you decide to side with the Imps director with a smile. You stop trying to take the couch.

>look
Lounge
A large common room.

There are a few couches strewn about the room, seemingly haphazardly.

>take 6
Taken.

>i
You are carrying:
  6 couches

* * *

>take couch
A little Imps-director angel appears on your right shoulder, and gently reminds you that other people need to use the couches too. A little social-director devil appears on your left shoulder, and tells you (in no uncertain terms) that the Imps-director can suck it. Realizing that you couldn't lift the couch by yourself anyway, you decide to side with the Imps director with a smile. You stop trying to take the couch.

>take 6
You can't see any such thing.

>take six
Taken.

>exit
But you aren't in anything at the moment.

>quit
Are you sure you want to quit?

>y
[ The game has finished ]

* * *

>take couch
A little Imps-director angel appears on your right shoulder, and gently reminds you that other people need to use the couches too. A little social-director devil appears on your left shoulder, and tells you (in no uncertain terms) that the Imps-director can suck it. Realizing that you couldn't lift the couch by yourself anyway, you decide to side with the Imps director with a smile. You stop trying to take the couch.

>take 1 couch
You can't see any such thing.

* * *

>take couch
A little Imps-director angel appears on your right shoulder, and gently reminds you that other people need to use the couches too. A little social-director devil appears on your left shoulder, and tells you (in no uncertain terms) that the Imps-director can suck it. Realizing that you couldn't lift the couch by yourself anyway, you decide to side with the Imps director with a smile. You stop trying to take the couch.

>take six
You can't see any such thing.

>i
You are carrying:
  six couches

* * *

>take couch
A little Imps-director angel appears on your right shoulder, and gently reminds you that other people need to use the couches too. A little social-director devil appears on your left shoulder, and tells you (in no uncertain terms) that the Imps-director can suck it. Realizing that you couldn't lift the couch by yourself anyway, you decide to side with the Imps director with a smile. You stop trying to take the couch.

>i
You are carrying:
  a couch

>l
Lounge
A large common room.

You can see five couches here.

* * *

>take couch
A little Imps-director angel appears on your right shoulder, and gently reminds you that other people need to use the couches too. A little social-director devil appears on your left shoulder, and tells you (in no uncertain terms) that the Imps-director can suck it. Realizing that you couldn't lift the couch by yourself anyway, you decide to side with the Imps director with a smile. You stop trying to take the couch.

>take all
one projector: Taken.
media kiosk: Taken.
projector screen: Taken.
couch: A little Imps-director angel appears on your right shoulder, and gently reminds you that people need to use the couches too. A little social-director devil appears on your left shoulder, and tells you (in no uncertain terms) that the Imps-director can suck it. You, realizing that you couldn't lift the couch by yourself anyway, decide to side with the Imps director with a smile. You stop trying to take the couch.
couch: A little Imps-director angel appears on your right shoulder, and gently reminds you that people need to use the couches too. A little social-director devil appears on your left shoulder, and tells you (in no uncertain terms) that the Imps-director can suck it. You, realizing that you couldn't lift the couch by yourself anyway, decide to side with the Imps director with a smile. You stop trying to take the couch.
couch: A little Imps-director angel appears on your right shoulder, and gently reminds you that people need to use the couches too. A little social-director devil appears on your left shoulder, and tells you (in no uncertain terms) that the Imps-director can suck it. You, realizing that you couldn't lift the couch by yourself anyway, decide to side with the Imps director with a smile. You stop trying to take the couch.
couch: A little Imps-director angel appears on your right shoulder, and gently reminds you that people need to use the couches too. A little social-director devil appears on your left shoulder, and tells you (in no uncertain terms) that the Imps-director can suck it. You, realizing that you couldn't lift the couch by yourself anyway, decide to side with the Imps director with a smile. You stop trying to take the couch.
couch: A little Imps-director angel appears on your right shoulder, and gently reminds you that people need to use the couches too. A little social-director devil appears on your left shoulder, and tells you (in no uncertain terms) that the Imps-director can suck it. You, realizing that you couldn't lift the couch by yourself anyway, decide to side with the Imps director with a smile. You stop trying to take the couch.
couch: A little Imps-director angel appears on your right shoulder, and gently reminds you that people need to use the couches too. A little social-director devil appears on your left shoulder, and tells you (in no uncertain terms) that the Imps-director can suck it. You, realizing that you couldn't lift the couch by yourself anyway, decide to side with the Imps director with a smile. You stop trying to take the couch.
big-screen TV: You make a valiant attempt at lifting the television. It's lighter than it looks, it must be a DLP, but due to its sheer bulk, you'll still need another person to help you lift it.

* * *

>take couch
A little Imps-director angel appears on your right shoulder, and gently reminds you that other people need to use the couches too. A little social-director devil appears on your left shoulder, and tells you (in no uncertain terms) that the Imps-director can suck it. Realizing that you couldn't lift the couch by yourself anyway, you decide to side with the Imps director with a smile. You stop trying to take the couch.

>x windows
The windows look out over the NRH quad. It's a gray, dreary mist outside, just like every other day in Rochester.

* * *

>take block
Which do you mean, a red block, a blue block or the green block?

>take red block
Taken.

>i
You are carrying:
  a red block

>l
Nursery
You can see five red blocks, four blue blocks and a green block here.

* * *

>e
North Side Hallway
The hallway is rather bright and cheery, and the sunlight plays nicely on a few brightly colored stripes that run the length of the wall, occasionally interspersed with giant hard drive platters. To the west is the lounge. To the north, the end of this hallway, and to the south, the elevator lobby.

Debug:

>l
North Side Hallway

>s
You can't go that way.

>n
You can't go that way.

>s
You can't go that way.

* * *

>e
North Side Hallway
The hallway is rather bright and cheery, and the sunlight plays nicely on a few brightly colored stripes that run the length of the wall, occasionally interspersed with giant hard drive platters. To the west is the lounge. To the north, the end of this hallway, and to the south, the elevator lobby.

Debug:

>n
End of the North Side Hallway
The end of the north-side hallway. To the north, you see the door marked "ARG room". To the east, you can see the L Hallway, which is somewhat ill-lit.

You can see a Big Drink Machine and a CD-R here.

Debug:

>e
Darkness
It is pitch dark, and you can't see a thing.

>w
End of the North Side Hallway
The end of the north-side hallway. To the north, you see the door marked "ARG room". To the east, you can see the L Hallway, which is somewhat ill-lit.

* * *

>e
Darkness
It is pitch dark, and you can't see a thing.

>turn on light switch
You switch the light switch on.

>turn off light switch
You switch the light switch off.

>turn on light switch
You switch the light switch on.

>w
End of the North Side Hallway
The end of the north-side hallway. To the north, you see the door marked "ARG room". To the east, you can see the L Hallway, which is somewhat ill-lit.

You can see a CD-R on the ground and a Big Drink Machine here.

>w
You can't go that way.

>turn off light switch
You can't see any such thing.

>turn on light switch
You can't see any such thing.

>s
North Side Hallway
The hallway is rather bright and cheery, and the sunlight plays nicely on a few brightly colored stripes that run the length of the wall, occasionally interspersed with giant hard drive platters. To the west is the lounge. To the north, the end of this hallway, and to the south, the elevator lobby.

>turn off light switch
That's already off.

>turn on light switch
You switch the light switch on.

* * *

>e
Darkness
It is pitch dark, and you can't see a thing.

>use switch
That's not a verb I recognise.

>switch light
You switch the light switch on.

L Hallway
A wretched hive of scum and villainy.

You can see a light switch here.

* * *

>e
Darkness
It is pitch dark, and you can't see a thing.

>turn on light
You have a feeling that Ryan will now approve of your being a member, since you've forced the L to be just a bit more social.
You switch the light switch on.

L Hallway
A wretched hive of scum and villainy. To the east lies the end of this hallway, and to the south, the project room.

You can see a light switch here.

>s
Project Room
The project room is a rather cramped room full of wood working and miscellaneous equipment. A pleasant light streams in from the two windows in the back of the room.

>n
L Hallway
A wretched hive of scum and villainy. To the east lies the end of this hallway, and to the south, the project room.

You can see a light switch here.

>e
End of the L Hallway
Bleak. Forboding. Stripey. It's a hallway. The research room is to the South.

>n
You can't go that way.

>s
Research Room
This room is packed to the gills with random electronics junk and half-finished (and half-baked) projects. You could really only find something of use in here if you knew what you were looking for beforehand.

You can see Howland here.

>talk to alex
You open your mouth to talk to Howland, but before you get the words out, she goes into a lengthy history story.
She starts to explain, "Well, Dan Lee and Darren once were out in Rochester proper, when..."
You fall asleep.
(Press any key)

>[enter]
Your eyes flutter open again. "And then James Kieliszek wrote this piece of software that..."
Your eyelids weigh down again.
(Press any key)

* * *

>e
Darkness
It is pitch dark, and you can't see a thing.

>e
End of the L Hallway
Bleak. Forboding. Stripey. It's a hallway. The research room is to the South.

>s
Research Room
This room is packed to the gills with random electronics junk and half-finished (and half-baked) projects. You could really only find something of use in here if you knew what you were looking for beforehand.

You can see a motor and Howland here.

>take motor
Taken.

>i
You are carrying a motor, and an unbearable lightness of being.

* * *

>n
End of the North Side Hallway
The end of the north-side hallway. To the north, you see the door marked "ARG room". To the east, you can see the L Hallway, which is somewhat ill-lit.

You can see a Big Drink Machine and a CD-R here.

Debug:

>i
You are carrying nothing.

* * *

>n
End of the North Side Hallway
The end of the north-side hallway. To the north, you see the door marked "ARG room". To the east, you can see the L Hallway, which is somewhat ill-lit.

You can see a Big Drink Machine and a CD-R here.

Debug:

>x
What do you want to examine?

>look
End of the North Side Hallway
The end of the north-side hallway. To the north, you see the door marked "ARG room". To the east, you can see the L Hallway, which is somewhat ill-lit.

* * *

>n
End of the North Side Hallway
The end of the north-side hallway. To the north, you see the door marked "ARG room". To the east, you can see the L Hallway, which is somewhat ill-lit.

You can see a Big Drink Machine and a CD-R here.

Debug:

>take cd-r
Taken.

>x cd-r
It's a normal -looking CD-R. Upon examination of the ink on the back, you decide that it is blank.

>label cd-r
That's not a verb I recognise.

>xyzzy
I think you have the wrong game.

>write
That's not a verb I recognise.

>n
ARG/Server Room
The ARG/Server room is full of a mix of old and older servers. It's kind of cold. There are four air conditioners lining the north side of the room where the windows ought to be.

You can see four air conditioners here.

>take ac
That's fixed in place.

>take 4 acs
You can't see any such thing.

>take 4 ac
You can't see any such thing.

>take the air conditioners
That's fixed in place.

>take server
You can't see any such thing.

>n
You can't go that way.

>s
End of the North Side Hallway
The end of the north-side hallway. To the north, you see the door marked "ARG room". To the east, you can see the L Hallway, which is somewhat ill-lit.

You can see a Big Drink Machine here.

>s
North Side Hallway
The hallway is rather bright and cheery, and the sunlight plays nicely on a few brightly colored stripes that run the length of the wall, occasionally interspersed with giant hard drive platters. To the west is the lounge. To the north, the end of this hallway, and to the south, the elevator lobby.

>s
Elevator Lobby
A large room that connects the two halves of floor with both each other and the outside world.

It looks like the RA has made some half-enthused effort to print and tack up ResLife-approved community signage. It's boring. You feel dumber for having read it.

>s
You can't go that way.

* * *

>n
End of the North Side Hallway
The end of the north-side hallway. To the north, you see the door marked "ARG room". To the east, you can see the L Hallway, which is somewhat ill-lit.

You can see a Big Drink Machine and a CD-R here.

Debug:

>use big drink machine
That's not a verb I recognise.

>turn on big drink
You switch the Big Drink Machine on.

>turn off big drink
You switch the Big Drink Machine off.

* * *

>n
End of the North Side Hallway
The end of the north-side hallway. To the north, you see the door marked "ARG room". To the east, you can see the L Hallway, which is somewhat ill-lit.

You can see a Big Drink Machine and a CD-R here.

Debug:

I beg your pardon?

>n
ARG/Server Room
The ARG/Server room is full of a mix of old and older servers. It's kind of cold. There are four air conditioners lining the north side of the room where the windows ought to be. It looks like someone has hooked up a console into the games server.

You can see four air conditioners, a console, and a server here.

>n
You can't go that way.

>x servers
The server is currently switched off.

* * *

>n
ARG/Server Room
The ARG/Server room is full of a mix of old and older servers. It's kind of cold. There are four air conditioners lining the north side of the room where the windows ought to be. It looks like someone has hooked up a console into the games server.

You can see four air conditioners, a console, and a server here.

>use console
You step up the console hooked directly up to the games server. Upon closer examination, it looks like some odd conglomeration of an 80s-era serial console and some nearly equally outdated 90s-era virtual reality technology.
 You see that someone has already opened Nethack. You start to play, when you hear a loud, raspy laugh behind you.
You feel a stabbing sensation as a needle is forcefully shoved into the side of your neck.

You black out...

Please press SPACE to continue.

>[enter]
Dungeon Level 1 - Starting Room
You can see a staircase here.

>use staircase
You feel like your god would be most displeased should you escape the dungeon. You decide against this brazen act of defiance.

>up
You feel like your god would be most displeased should you escape the dungeon. You decide against this brazen act of defiance.

* * *

I beg your pardon?

>use console
You can't see any such thing.

>n
ARG/Server Room
The ARG/Server room is full of a mix of old and older servers. It's kind of cold. There are four air conditioners lining the north side of the room where the windows ought to be. It looks like someone has hooked up a console into the games server.

You can see four air conditioners, a console, and a server here.

* * *

>look
Dungeon Level 1 - Starting Room
You can see a staircase here.

* * *

>n
End of the North Side Hallway
The end of the north-side hallway. To the north, you see the door marked "ARG room". To the east, you can see the L Hallway, which is somewhat ill-lit.

You can see a Big Drink Machine and a CD-R here.

Debug:

>n
ARG/Server Room
The ARG/Server room is full of a mix of old and older servers. It's kind of cold. There are four air conditioners lining the north side of the room where the windows ought to be. It looks like someone has hooked up a console into the games server.

Clockfort stares at you with narrowed eyes inbetween hurridly typing on various consoles.

Cohoe looks relaxed.

You can also see a console, four air conditioners, and a server here.

Debug:

>turn off server
You feel a satisfying click at the end of the power button's motion, and the noise level in the room softens to a more reasonable level as the whirring of fans and hard drives comes to a stop.

You switch the server off.

>turn on server
You switch the server on.

* * *

>n
ARG/Server Room
The ARG/Server room is full of a mix of old and older servers. It's kind of cold. There are four air conditioners lining the north side of the room where the windows ought to be. It looks like someone has hooked up a console into the games server.

Clockfort stares at you with narrowed eyes inbetween hurridly typing on various consoles.

Cohoe looks relaxed.

You can also see a console, four air conditioners, and a server here.

Debug:

>use console
You step up the console hooked directly up to the games server. Upon closer examination, it looks like some odd conglomeration of an 80s-era serial console and some nearly equally outdated 90s-era virtual reality technology.
 You see that someone has already opened Nethack. You start to play, when you hear a loud, raspy chuckle behind you.
You feel a stabbing sensation as a needle is forcefully shoved into the side of your neck.

You black out...

Please press SPACE to continue.

>using console
That's not a verb I recognize.

>use the console
That's not a verb I recognize.

* * *

>use console
You step up the console hooked directly up to the games server. Upon closer examination, it looks like some odd conglomeration of an 80s-era serial console and some nearly equally outdated 90s-era virtual reality technology.
 You see that someone has already opened Nethack. You start to play, when you hear a loud, raspy chuckle behind you.
You feel a stabbing sensation as a needle is forcefully shoved into the side of your neck.

You black out...

Please press SPACE to continue.

>[enter]
Dungeon Level 1 - Starting Room
You can see a staircase and a pet kitten here.

* * *

>l
Dungeon Level 1 - Starting Room
You can see a stairs here.